NO ./texture/doom1.png
SO 			./texture/doom2.png
WE 					./texture/doom3.png
EA ./texture/doom4.png

C 0		,			255,       255
F 160,		160,			160

11111111111111111111111111111
10010000000000010100000000001
10000000000000000000000000001
1111111111D11000N000000000001
10000000000010000000000000001
10111000000010000000000000001
111 1111111111111111111111111