
NO ./texture/doom1.png

SO ./texture/doom2.png
WE ./texture/doom3.png




EA ./texture/doom4.png



C 0,255,255

F 160,160,160









        1111111111111111111111111
        10000D0000110000000000001
        1011010001110000000000001
        10011110000D0000000000001
111111111011000001110000000000001
10000000001100000111011111D111111
1111D111111111D11100000010001
11110111111111011101010010001
110000001101010111000000D0001
1000000010100000D00000010001
10000000000000001101010010001
11000001110101011111011110N0111
11110111 1110101 101111010001
11111111 1111111 111111111111

