NO ./texture/xpm/wolfestein/blue_wall.xpm
SO ./texture/xpm/wolfestein/brick_wall.xpm
WE ./texture/xpm/wolfestein/grey_wall.xpm
EA ./texture/xpm/wolfestein/steel_wall.xpm

C 0,255,3
F 160,160,160

        1111111111111110111111111
        1000000000110001000000001
        1011000001110000000000001
        10010000000000000000000001
111111111011000001110000000000001
100000000011000001110111111111111
11110111111111011100000010001
11110111111111011101010010001
11000000110101011100000010001
10000000000000001100000010001
10000000000000001101010010001
11000001110101011111011110N0111
11110111 1110101 	101111010001
11111111 1111111 	111111111111