NO ./texture/doom1.png
SO ./texture/doom2.png
WE ./texture/doom3.png
EA ./texture/doom4.png

C 0,255,255
F 160,160,160

11111111111111111111111111111
10010001000000010100000000001
100D0001000000000000000000001
10010001000010000000000000001
1000000D0000000000011D1111111
10111001000000000N00000000001
11111111111111111111111111111