NO ./texture/doom1.png
SO ./texture/doom2.png
WE ./texture/doom3.png
EA ./texture/doom4.png

C 0,255,255
F 160,160,160

11111111111111111111111111111
10010000000000010100000000001
10010001000000010000000100001
1001000110001000000000010N111
10000001000001100001111100001
10111000000000100000000000001
11111111111111111111111111111