NO ./texture/doom1.png
SO ./texture/doom2.png
WE ./texture/doom3.png
EA ./texture/doom4.png

C 0,255,255
F 160,160,160

11111111111111111111111111111
10000000000000000000000000001
10011100000000000000000000001
100000000000011111D1111100001
10000000000000000000000000001
10000000000000N00000000000001
10000000000000000000000000001
11111111111111111111111111111