11111111111111111111111111111
10010000000000000000000000001
10010000000000000000000000001
1001000000000000N000000000001
10000000000000000000000000001
10111000000000001100000000001
111 111111111111  11111111111