NO ./texture/doom1.png
SO 			./texture/doom2.png
WE 					./texture/doom3.png
EA ./texture/doom4.png

C 0,255,255 F 160,160,160

        1111111111111111111111111
        1000000000110000000000001
        1011000001110000000000001111
        10010000000000000000000000001
111111111011000001110000000000001111
100000000011000001110111111111111
11110111111111011100000010001
11110111111111011101010010001
11000000110101011100000010001
10000000001000001100000010001
1000000001 1000000011010100101
11000001111101011111011110N0111
11110111 1110101 101111010001
11111111 1111111 111111111111